#######################
##          G        ##
##                   ##
##                   ##
##                   ##
##                   ###################
##                                  G ##
##          C                         ##
##                                    ##
##   P                                ##
##                        G           ##
########################################
