#######################                                             
##                   ##                                                         
##                   ##
##   P               ##
##                   ##
##                   ####################
##                                     ##
##          C                          ##
##                              ##     ##
##                              ##     ##
##                              ##     ##
#########################################

