        ######
       ##   G##
   ######    ##
  ##       #  ##
  ##   #     ##
  ### # #  ###
 ##         ##
 ##      ## ##
### ##      ##
##     #     ##
##    C     ##
###P  #  ####
 ##  ####
  ####
