  #####
 ##    ####
 ## C     #####
##### ## G##G ##
##  # #P ##   ##
##      ##     ##
##  ## ##    #####
##     ##       ###
#### # ###   #   ##
 ##      ## ##   ##
  ###     ##     ##
   ##            ##
    ###     ##  ##
     ###     ####
      ##########