 ######
##   P##
## C  ###
##      ##
##### # ##
##G     ##
 ########