              ###########
              ##      ####### 
           #####      ###
    ###########P#  ## ######################
  #######    ## ##                       #####
###           # #  ####################   ###### 
###        #### #      G######################
##     ###  C   ##  ##                 ##  
##       #  ######  ## ## ###########  #
#####    ###  ######## ## #            #
###     ####         #    #            #
##     #####         ######            #   
 #    ######                           # 
 ##                  ################  #
 ################  ###               ##  
                ####
                