    ########
   ##G     ##
########    ##
##     ##    ##
##      P#   ##
##  #  C #    ##
##   #  ##    ##
##    ###    ##
 ##         ##
  #######  ##
        ####