   ####
  ##  ##
 ##  C####
##       ##
##     # ##
###  ###P##
 ##  ######
 ##  #   G#
 ##     ###
 ###    ##
 ########