 ##############################
##           ##  ####  #####  G#
##  P     C  ##           ##  ##      
##           ##  ####  #####  ##  
##               ####         ##
##           ##        ####   ##
 ##############################
