     #######
     ##    ##
    ##  C  ##
   ##  #   ##
   ##P #    ###
  #### ###  ########
  ##        ###  ########
  ##   ########         ##
  ##                 #   ##
   ############## ## #   ##
    ##    #  ##         ##
    #G        ### # #  ##
     #####          ###
        ####     ####
           ######