         ####
    ######  ##
  ###       ##
  ##   ## # ##
  ##   ##P  G#
 ##    #######
 ##    ###  ##
 ##  ####  C ##
 ##          ##
 ##   ####  ##
  ###########