    ####
  ###  ###
###      ##
##  C#     ##  #####
##     #    ####   ##
## ###            ##
##        #####   ##
 ####    ## ##   ###
   #### ##  P#    ##
    ##  ##  ####  ##
    ##      ###   ##
   ############   ##
   ##G           ##
    ##############