         #####
     ##### P#####
    ##   #      ##
    ## #       C ##
    ##   #       ##
     ### #       ##
      ##   ### ####
    #### ####   ##
   ##         ####
   ##  ###  #  ##
  ##  ##  # #  ##
  ##           ##
  ##   G#########
   #######