 ###########
##         ##          ########
##  # PC #  ##       ###     ###
##         ##       ##         ###
 ####   ####       ##            ##
  ##     ##       ##     ####    ##
  ##     ##       ##    ##  ##   ##
  ##     ##       ##   ##   ##   ##
  ##     ##      ##    ##   ##    ##
   ##     ##    ##    ##     ##    ##
    ##     ######    ##       ##     ##
     ##             ##         ##      ###      
      ###          ##           ##      G####
        ############             #########  