#################
##P            ##
##     C       ##
##            G##
#################