           ######
    ####  ##   P##
  ###  ####   ######
###               #####
##    #       C   ## G##
##      ####   ###     ##
### ###    ######      ##
 ##                 #####
 ################  ###
                ####