#################################
##            ##  ####  #####  G#
##   P     C  ##           ##  ##      
##            ##  ####  #####  ##  
##                ####         ##
##            ##        ####   ##
#################################
