 #####
##  ###
##    ##########
## #  ##P      ####
## #   ### ##   C ##
## # #  #         ##
## #    ## # #######
##G#         ##
#####   ######
    #####