#########################
##   P       ##  ####  G#
##      C        ####  ##
##           ##  ##    ##
###############  ##    ##
             ##  ##  ####
             ##  ##    ## 
             ##        ## 
             ######    ##
                  #####
