   ####
  ##P ##
  ##  ##
  ##C  #####
  ##   #   ##
 ###   # # ##
###        ##
##     # ###
 ##### # ##
    ##   ##
     ###G##
       ###