   #######
 ###      ##
 ##  C###  ##
 ##        ##
### #   P  ##
##   ########
##   #    ###
## #     ###
 #       ###
  #### #  ###
    ## #   ###
    ##      ##
     #####G###
        ####