    ########
  #####  #####
 ###  #  #G  ##
 ##  C#  ##  ##
 ##   #       ##
 ##   #  #    ###
 ##   #  #########
 ##   #         ##
 ##   #   ####  ##
 ###  #######  P##
 ###            ##
  ###          ###  
   ##############