 ##########
##        ###
### ##### ######
##           #######
### #####          ##
 #G  #### ### ###  ##
  #         #      ##
 ###### ##### ###  ##
##  P       #  C  ##
##        #   ##  ##
 #######  ##########
       ######