 ######
 ############
 ##       P######
 ##  C # ####   ##
 ##  ###        ##
 ##  #### ##    #####
###  #### ##       ##
##   #     # ## ####
##         # #  G###
######  ####     ###
     ########   ####
         ###########